10
9
  #####
  #   #
  #   #
### * ###
#  *.*  #
#  *.*  #
#  *.*  #
###$$$###
  # @ #
  #####
