17
6
######
#@   #
# $  #
#   ##
#    #
#    #
###  #
#    #
# #  #
#    #
#$#  #
#    #
#    #
#    #
#    #
#. #.#
######

