6
7
#######
#@    #
# $   #
#   . #
## ####
 ###
