14
14
##############
#####    #####
##### ## #####
##### ## #####
##### ## #########        
#@    #          #
# $  .#      ### #
#     #     .    #
## ##### #########
 # #   # #
 # ##### #
 #       #
 #       #
 #########
