6
7
#######
#@    #
# $  .#
#     #
## ####
 ###
